1 1 1 1 1 1 1 1 1 1 1 1 1 1 1 1 1 1 1 1 1 1 1 1 1 1 1 1 1 1 1 1 1 1 1 1 1 1 1 1 1 1 1 1 1 1 1 1 1 1
1 0 0 0 0 0 0 0 7 0 0 0 0 0 0 7 0 0 0 0 3 3 3 3 3 3 3 3 3 3 0 0 0 0 0 0 0 0 0 0 0 0 0 0 0 0 0 0 0 1
1 0 0 0 0 0 0 0 0 0 0 0 0 0 0 0 0 0 0 0 3 5 5 5 5 5 5 5 5 3 0 0 1 1 1 1 1 0 0 0 0 0 0 0 0 0 0 0 0 1
1 0 0 1 1 1 1 6 1 1 0 0 0 0 0 0 0 0 0 0 3 5 7 5 5 5 7 5 5 3 0 0 1 0 0 0 1 0 0 0 0 0 0 0 0 0 0 0 0 1
1 0 0 1 0 0 0 0 0 1 0 0 0 0 0 0 0 0 0 0 3 5 5 5 9 5 5 5 5 3 0 0 1 0 0 0 1 0 0 0 0 0 0 0 0 0 0 0 0 1
1 0 0 1 0 0 0 0 0 1 0 0 7 0 0 7 0 0 0 0 3 5 5 5 5 5 5 5 5 3 0 0 1 0 0 0 6 0 0 0 0 0 0 0 0 0 0 0 0 1
1 0 0 1 0 0 0 0 0 1 0 0 0 0 0 0 0 0 0 0 3 5 7 5 5 5 7 5 5 3 0 0 1 1 1 1 1 0 0 0 0 0 0 0 0 0 0 0 0 1
1 0 0 6 0 0 0 0 0 6 0 0 0 0 0 0 0 0 0 0 3 5 5 5 5 5 5 5 5 3 0 0 0 0 0 0 0 0 0 1 1 1 1 1 1 0 0 0 0 1
1 0 0 1 0 0 0 0 0 1 0 0 0 0 0 0 0 0 0 0 3 5 5 5 9 5 5 5 5 3 0 0 0 0 0 0 0 0 0 1 0 0 0 0 1 0 0 0 0 1
1 0 0 1 1 1 1 1 1 1 0 0 0 0 0 0 0 0 0 0 3 5 5 5 5 5 5 5 5 3 0 0 0 0 0 0 0 0 0 1 0 0 0 0 1 0 0 0 0 1
1 0 0 0 0 0 0 0 0 0 0 0 0 0 0 0 0 0 0 0 3 3 3 3 8 3 3 3 3 3 0 0 0 0 0 0 0 0 0 6 0 0 0 0 6 0 0 0 0 1
1 3 3 3 3 3 3 3 3 3 3 3 3 3 3 3 3 3 3 3 3 0 0 0 2 0 0 0 0 3 3 3 3 3 3 3 3 3 3 3 3 3 3 3 3 3 3 3 3 1
1 4 0 0 0 0 0 0 0 0 0 0 0 0 0 0 0 0 0 0 3 0 0 0 2 0 0 0 0 3 0 0 0 0 0 0 0 0 0 1 0 0 0 0 1 0 0 4 0 1
1 4 0 0 1 1 1 6 1 1 0 0 0 0 0 0 0 0 0 0 3 0 0 0 2 0 0 0 0 3 0 0 0 0 0 0 0 0 0 1 1 1 6 1 1 0 0 4 0 1
1 4 0 0 1 0 0 0 0 1 0 0 0 0 0 0 0 0 0 0 3 0 0 0 2 0 0 0 0 3 0 0 0 0 0 0 0 0 0 0 0 0 0 0 0 0 0 4 0 1
1 4 0 0 1 0 0 0 0 1 0 0 7 0 0 7 0 0 0 0 3 0 0 0 2 0 0 0 0 3 0 0 0 0 0 0 0 0 0 0 0 0 0 0 0 0 0 4 0 1
1 4 0 0 1 0 0 0 0 1 0 0 0 0 0 0 0 0 0 0 3 0 0 0 2 0 0 0 0 3 0 0 1 1 1 1 6 1 1 0 0 0 0 0 0 0 0 4 0 1
1 4 0 0 6 0 0 0 0 6 0 0 0 0 0 0 0 0 0 0 3 0 0 0 2 0 0 0 0 3 0 0 1 0 0 0 0 0 1 0 0 0 0 0 0 0 0 4 0 1
1 4 0 0 1 0 0 0 0 1 0 0 0 0 0 0 0 0 0 0 3 0 0 0 2 0 0 0 0 3 0 0 1 0 0 0 0 0 1 0 0 0 0 0 0 0 0 4 0 1
1 4 0 0 1 1 1 1 1 1 0 0 0 0 0 0 0 0 0 0 3 0 0 0 2 0 0 0 0 3 0 0 1 0 0 0 0 0 6 0 0 0 0 0 0 0 0 4 0 1
1 4 0 0 0 0 0 0 0 0 0 0 0 0 0 0 0 0 0 0 3 0 0 0 2 0 0 0 0 3 0 0 1 1 1 1 1 1 1 0 0 0 0 0 0 0 0 4 0 1
1 3 3 3 3 3 3 3 3 3 3 3 3 3 3 3 3 3 3 3 3 3 3 3 3 3 3 3 3 3 3 3 3 3 3 3 3 3 3 3 3 3 3 3 3 3 3 3 3 1
1 4 0 0 0 0 0 0 0 0 0 0 0 0 0 0 0 0 0 0 3 0 0 0 0 0 0 0 0 3 0 0 0 0 0 0 0 0 0 0 0 0 0 0 0 0 0 4 0 1
1 4 0 0 1 1 1 6 1 1 0 0 0 0 0 0 0 0 0 0 3 0 0 0 0 0 0 0 0 3 0 0 0 0 0 0 0 0 0 0 0 0 0 0 0 0 0 4 0 1
1 4 0 0 1 0 0 0 0 1 0 0 7 0 7 0 0 0 0 0 3 0 7 0 0 0 7 0 0 3 0 0 0 1 1 1 6 1 1 0 0 0 0 0 0 0 0 4 0 1
1 4 0 0 1 0 0 0 0 1 0 0 0 0 0 0 0 0 0 0 3 0 0 0 0 0 0 0 0 3 0 0 0 1 0 0 0 0 1 0 0 0 0 0 0 0 0 4 0 1
1 4 0 0 6 0 0 0 0 6 0 0 0 0 0 0 0 0 0 0 3 0 0 0 0 0 0 0 0 3 0 0 0 1 0 0 0 0 1 0 0 0 0 0 0 0 0 4 0 1
1 4 0 0 1 0 0 0 0 1 0 0 0 0 0 0 0 0 0 0 3 0 0 0 0 0 0 0 0 3 0 0 0 6 0 0 0 0 6 0 0 0 0 0 0 0 0 4 0 1
1 4 0 0 1 1 1 1 1 1 0 0 0 0 0 0 0 0 0 0 3 0 0 0 0 0 0 0 0 3 0 0 0 1 0 0 0 0 1 0 0 0 0 0 0 0 0 4 0 1
1 4 0 0 0 0 0 0 0 0 0 0 0 0 0 0 0 0 0 0 3 0 0 0 0 0 0 0 0 3 0 0 0 1 1 1 1 1 1 0 0 0 0 0 0 0 0 4 0 1
1 3 3 3 3 3 3 3 3 3 3 3 3 3 3 3 3 3 3 3 3 3 3 3 3 3 3 3 3 3 3 3 3 3 3 3 3 3 3 3 3 3 3 3 3 3 3 3 3 1
1 0 0 0 0 0 0 0 0 0 0 0 0 0 0 0 0 0 0 0 3 0 0 0 0 0 0 0 0 3 0 0 0 0 0 0 0 0 0 0 0 0 0 0 0 0 0 0 0 1
1 0 7 0 0 0 0 0 7 0 0 0 0 0 0 0 0 0 0 0 3 0 0 0 0 0 0 0 0 3 0 0 0 0 7 0 0 7 0 0 0 0 0 0 0 0 0 0 0 1
1 0 0 0 0 1 1 6 1 1 0 0 0 0 1 1 6 1 1 0 3 0 0 0 0 0 0 0 0 3 0 1 1 6 1 1 0 0 0 0 1 1 1 6 1 1 0 0 0 1
1 0 0 0 0 1 0 0 0 1 0 0 0 0 1 0 0 0 1 0 3 0 0 0 0 0 0 0 0 3 0 1 0 0 0 1 0 0 0 0 1 0 0 0 0 1 0 0 0 1
1 0 0 0 0 1 0 0 0 1 0 0 0 0 1 0 0 0 1 0 3 0 0 0 0 0 0 0 0 3 0 1 0 0 0 6 0 0 0 0 1 0 0 0 0 1 0 0 0 1
1 0 0 0 0 6 0 0 0 6 0 0 0 0 6 0 0 0 6 0 3 0 0 0 0 0 0 0 0 3 0 1 0 0 0 1 0 0 0 0 6 0 0 0 0 6 0 0 0 1
1 0 0 0 0 1 1 1 1 1 0 0 0 0 1 1 1 1 1 0 3 0 0 0 0 0 0 0 0 3 0 1 1 1 1 1 0 0 0 0 1 1 1 1 1 1 0 0 0 1
1 0 0 0 0 0 0 0 0 0 0 0 0 0 0 0 0 0 0 0 3 0 0 0 0 0 0 0 0 3 0 0 0 0 0 0 0 0 0 0 0 0 0 0 0 0 0 0 0 1
1 0 0 0 0 0 0 0 0 0 0 0 0 0 0 0 0 0 0 0 3 0 0 0 0 0 0 0 0 3 0 0 0 0 0 0 0 0 0 0 0 0 0 0 0 0 0 0 0 1
1 0 7 0 0 0 0 0 0 0 0 0 0 0 0 0 0 0 7 0 3 3 3 3 3 3 3 3 3 3 0 0 0 0 0 0 0 0 0 7 0 0 0 0 0 0 0 7 0 1
1 0 0 0 0 0 0 0 0 0 0 0 0 0 0 0 0 0 0 0 0 0 0 0 0 0 0 0 0 0 0 0 0 0 0 0 0 0 0 0 0 0 0 0 0 0 0 0 0 1
1 1 1 1 1 1 1 1 1 1 1 1 1 1 1 1 1 1 1 1 1 1 1 1 1 1 1 1 1 1 1 1 1 1 1 1 1 1 1 1 1 1 1 1 1 1 1 1 1 1